1111111
1P0C001
1EC1111
1C101C1
1111111