111111
100000
1E01C1
1C0001
1P0001
111111