111111
10Y001
1E01C1
1C0001
1P0001
111111