111111111111111111111
1E000000C00000C000001
101011001010001010101
101001010101001001011
1P0000C00C000000000C1
111111111111111111111