111111
100001
1E0101
1C0001
1P0001
111111