111111
10P001
1E01C1
1C0001
111111